fox = tilki
bed = yatak
regard = önemsemek
cashier = kasiyer
crab = yengeç
fail = başarısız
enjoy = eğlenmek
fun = eğlence
hill = tepe
introduce = tanıştırmak
laugh = gülmek
hurt = incinmek (hört)
decide = karar vermek
cotton = pamuk
improve = geliştirmek
desert = çöl
shark = köpek balığı
state = ifade etmek
river = nehir
demand = talep
certain = kesin (sörtın)
evening = akşam
away = uzak
describe = tasvir etmek,betimlemek
maouth = ağız
celebrate = kutlamak
wire = tel
sand = kum
heavy = ağır
skin = cilt
wild = vahşi
hug = sarılmak
silent = sessiz
spring = ilkbahar
correct = doğru
spot = nokta
west = batı
poor = fakir
soft = yumuşak
carry = taşımak
crowd = kalabalık
stone = taş
greengrocer = manav
forgive = bağışlamak (forgiv)
south = güney
east = doğu
moon = ay
hate = nefret etmek
worry = endişe etmek
shut = kapamak
pick = almak,toplamak
lawyer = avukat
imagine = hayal etmek
deliver = teslim etmek
lift = kaldırmak
care = önemsemek
lake = göl
order = sipariş vermek
grass = çimen
meat = et

