begin = başlamak
add = eklemek
soldier = asker
hold = tutmak
engineer = mühendis
fox = tilki
bed = yatak
again = tekrar,yeniden
cow = inek
join = katılmak
regard = önemsemek
box = kutu
apple = elma
drive = araba sürmek
wash = yıkamak
cashier = kasiyer
banker = bankacı
monkey = maymun
elephant = fil
crab = yengeç
fail = başarısız
enjoy = eğlenmek
store = mağaza
different = farklı
eye = göz
duck = ördek
connect = bağlanmak
fun = eğlence
hand = el
car = araba
hill = tepe
blue = mavi
chicken = tavuk
introduce = tanıştırmak
laugh = gülmek
father = baba
air = hava
donkey = eşek
chief = şef
hurt = incinmek
america = amerika
enter = girmek
finish = bitirmek
decide = karar vermek
but = fakat
army = ordu
hot = sıcak
language = dil, lisan
fireman = itfaiyeci
light = ışık
body = vücut
cotton = pamuk
improve = geliştirmek
desert = çöl
hairdresser = kuaför
friend = arkadaş
about = hakkında
clean = temiz
horse = at
ball = top
man = adam
year = yıl
actor = aktör, erkek oyuncu
shark = köpek balığı
deep = derin
point = nokta
mother = anne
state = ifade etmek
town = kasaba
river = nehir
demand = talep, istek
old = yaşlı
small = küçük
class = sınıf
table = masa
eagle = kartal
certain = kesin
write = yazmak
dislike = sevmemek
fast = hızlı
evening = akşam
dead = ölü
captain = kaptan
cat = kedi
important = önemli
food = yemek
corner = köşe
hair = saç
spider = örümcek
away = uzak
colour = renk
long = uzun
change = değiştirmek
detail = detay
student = öğrenci
fashion designer = moda tasarımcısı
human = insan
protect = korumak
create = oluşturmak
early = erken
follow = takip etmek
family = aile
home = ev
step = adım
describe = tasvir etmek,betimlemek
maouth = ağız
celebrate = kutlamak
water = su
hat = şapka
lie = yalan
island = ada
little = küçük
wire = tel
sand = kum
pass = pas vermek, geçirmek
wait = beklemek
heavy = ağır
skin = cilt
penguin = penguen
country = ülke
driver = şoför
fight = kavga etmek
here = burada
room = oda
cold = soğuk
singer = şarkıcı
book = kitap
wild = vahşi
hug = sarılmak
interesting = ilginç
silent = sessiz
miss = kaçırmak
next = sonraki
large = geniş
plane =  uçak
like = sevmek
spring = ilkbahar
letter = mektup
teacher = öğretmen
woman = kadın
paper = kağıt
mouse = fare
zoo = hayvanat bahçesi
look = bakmak
milk = süt
story = hikaye
correct = doğru
please = lütfen
black = siyah
report = rapor
spot = nokta 
west = batı
street = cadde
time = zaman
child = çocuk
poor = fakir
butterfly = kelebek
wall = duvar
farmer = çiftçi
always = her zaman
soft = yumuşak
bird = kuş
shop = dükkan
carry = taşımak
bring = getirmek
crowd = kalabalık
design = tasarlamak
stone = taş
end = son
dog = köpek
greengrocer = manav
forgive = bağışlamak
kick = tekme atmak
high = yüksek
south = güney
level = seviye
ice = buz
east = doğu
fish = balık
lion = aslan
number = sayı, numara
barber = berber
answer = cevap
map = harita
rich = zengin
moon = ay
hate = nefret etmek
sun = güneş
worry = endişe etmek
fruit = meyve
zebra = zebra
flower = çiçek
game = oyun
help = yardım
shoulder = omuz
information = bilgi
picture = resim
job = meslek
shut = kapamak
rain = yağmur
nurse = hemşire
mechanic = tamirci
lose = kaybetmek
morning = sabah
pick = almak,toplamak
lawyer = avukat
summer = yaz
question = soru
africa = afrika
school = okul
imagine = hayal etmek
dark = koyu, karanlık
art = sanat
doctor = doktor
special = özel
kill = öldürmek
stay = kalmak
clear = temizlemek
alone = yalnız
deliver = teslim etmek
tree = ağaç
way = yol
idea = fikir
animal = hayvan
lift = kaldırmak
best = en iyi
care = önemsemek
feel = hissetmek
heart = kalp
garden = bahçe
lake = göl
easy = kolay
company = şirket
money = para
take = almak
police = polis
order = sipariş vermek
low = düşük
stand = ayakta durmak
winter = kış
cook = pişirmek
yellow = sarı
beaitiful = güzel
continue = devam etmek
door = kapı
shoe = ayakkabı
grass = çimen
happy = mutlu
meat = et
sell = satmak